23 36
2 2 2 2 2 2 2 2 2 2 2 2 2 2 2 2 2 2 2 2 2 2 2 2 2 2 2 2 2 2 2 2 2 2 2 2
2 6 0 0 0 0 0 0 0 0 0 5 0 0 0 0 0 0 0 4 0 0 4 2 6 0 0 0 0 0 0 0 0 0 0 2
2 6 0 0 0 0 0 0 0 0 0 0 0 0 0 0 0 0 0 0 0 0 4 2	6 0 0 0 0 0	0 0 0 0 0 2
2 6 0 0 0 0 2 0 0 0 0 0 0 0 0 0 0 0 0 0 0 0 4 2	6 0 0 2 2 2 2 0 0 0 2 2
2 6 0 0 0 4 2 6 0 0 0 0 0 0 0 0 0 0 0 0 0 0 4 2	6 0 0 0 4 2	2 0 0 0 2 2
2 6 0 0 0 4 2 6 0 0 0 0 0 0 0 0 0 0 0 0 0 0 4 2	6 0 0 0 4 2	2 6 0 4 2 2
2 6 0 0 0 4 2 6 0 0 0 0 0 0 0 0 0 0 0 0 0 0 4 2	6 0 0 0 4 2	2 6 0 4 2 2
2 6 0 1 0 4 2 6 3 0 0 3 0 0 0 0 0 0 0 6 0 0 4 2	6 0 0 0 4 2	2 6 0 4 2 2
2 2 2 2 2 2 2 3 2 2 2 2 2 2 2 2 2 2 2 2 0 0 4 2	6 0 0 0 4 2	2 6 0 4 2 2
2 0 0 0 0 0 5 5 0 0 2 2 2 0 0 0 0 0 2 2 0 0 4 2	6 0 0 2 2 2	2 6 0 4 2 2
2 6 0 0 0 0 0 0 0 0 0 5 0 0 0 0 0 0 0 4 0 0 4 2	6 0 0 0 4 2	2 6 0 4 2 2
2 6 0 0 0 0 0 0 0 0 0 0 0 0 0 0 0 0 0 0 0 0 4 2	6 0 0 0 4 2	2 6 0 4 2 2
2 6 0 0 0 0 0 0 0 0 0 0 0 0 0 0 0 0 0 0 0 0 4 2	6 0 0 0 4 2	2 6 0 4 2 2
2 6 0 0 0 0 0 0 0 0 0 0 0 0 0 0 0 0 0 0 0 0 4 2	6 0 0 0 4 2	2 6 0 4 2 2
2 6 0 0 0 3 0 0 3 0 0 3 0 0 0 0 0 0 0 6 0 0 4 2	2 2 0 0 4 2	2 6 0 4 2 2
2 6 0 0 2 2 3 3 2 2 2 2 2 2 2 2 2 2 2 2 2 2 2 2	6 0 0 0 4 2	2 6 0 4 2 2
2 6 0 0 2 2 5 5 2 2 2 2 2 2 2 2 2 2 2 2 0 0 4 2	6 0 0 0 4 2	2 6 0 4 2 2
2 6 0 0 0 0 0 0 0 0 0 5 0 0 0 0 0 0 0 4 0 0 4 2	6 0 0 0 4 2	2 6 0 4 2 2
2 6 0 0 0 0 0 0 0 0 0 0 0 0 0 0 0 0 0 0 0 0 4 2	6 0 0 0 4 2	2 6 0 4 2 2
2 6 0 0 0 0 0 0 0 0 0 0 0 0 0 0 0 0 0 0 0 0 4 2	6 0 0 2 2 2	2 6 0 4 2 2
2 6 0 0 0 0 0 0 0 0 0 0 0 0 0 0 0 0 0 0 0 0 0 0	0 0 0 0 4 2	2 6	0 0	0 0
2 6 0 0 0 3 0 0 3 0 0 3 0 0 0 0 0 0 0 6 0 0 0 0 0 0 0 0 4 2 2 6 0 0 0 0
2 2 2 2 2 2 3 3 2 2 2 2 2 2 2 2 2 2 2 2 2 2 2 2 2 2 2 2 2 2 2 2 2 2 2 2